during-вовремя
conversation-разговор
accident - случайно
junp over = перепрыгнул
guilt- вина
check out - выехать
remeined  -остался
effords - усилия 
introduce - представлять (кому-то)
a favour - одолжение
put off - откладывть
quikly - тихо
loudly - громко 
considerebly -значительно                 !!!!!!!!!!!!!!!!!!!!!!!!!!!!!!!!!!!!!!!!!!!!!!!!!!!!!!!!!!!!!!                
significantly - значительно
moved - переехать
consider - считать
opportunity - возможность
reviced - повторил
gave up - сдаться
getting touch - связаться
matter - дело 
partly - частично
divided - делить
appeared - появился
suddenly -вдруг
immediately -сразу-же
greatly - сильно
described - описал
quite rary - довольно редко
issue - вопрос
fill in - заполнил
annifarsary - годовщина
tended - склоны(к)
deserve - заслужить 
almost - практически
figues - цифры
recive- изобретать
lend - приводить
catch - поймать
current - текущая
be out - отсутствует
require - требовать
innocent - невинный
detend - защащать
enemy - враг
the flanc - забор
outstanding - выдающийся
let - позволять
leave - уезжать
brought - принес
mean - намереваться
sit - сидеть
stand - стоять
lose - терять
meet - встречаь
set - ставить
classmate - одноклассник
set up - основать                             !!!!!!!!!!!!!!!!!!!!!!
by heart - наизусть
pieces- куски
sell - продавать
grow - расти
contest - конкурс
by - покупать
space - пространство
send - отправить
notification - уведомление
healtly - здоровье
definite - определенное
hurt - ушиб
arm -рука
properly - правильно  !!!!!!!!!!!!!!!!!!!!!!!!!!!!!!!!!!!!!!!!!!!!
thief - вовр
masterpeace - шедевр